TST = "countries/Test.txt"
ACR = "countries/Acreon.txt"
AET = "countries/Aethos.txt"
AKA = "countries/Akari.txt"
AKI = "countries/Akito.txt"
AKS = "countries/Akashiro.txt"
ALA = "countries/Alamara.txt"
ALZ = "countries/Alazorr.txt"
AND = "countries/Andliria.txt"
ANR = "countries/Andromeda.txt"
AME = "countries/Amestris.txt"
AQM = "countries/Regnum Aquiarus.txt"
ARC = "countries/Arcael.txt"
ARK = "countries/Arkan.txt"
ARR = "countries/Arkania.txt"
ART = "countries/Arratis.txt"
ASH = "countries/Ashkavar.txt"
ASP = "countries/Asper Tunga.txt"
ASR = "countries/Asren.txt"
AST = "countries/Astalasi.txt"
AUR = "countries/Aurumflora.txt"
AVA = "countries/Avalor.txt"
AXE = "countries/Axelm.txt"
AZE = "countries/Azeraan.txt"
AZU = "countries/Azure.txt"
BAN = "countries/Bannover.txt"
BAR = "countries/Bardonia.txt"
BEE = "countries/Beepek.txt"
BOU = "countries/Boulderov.txt"
BOV = "countries/Bovinica.txt"
CAA = "countries/Calarith.txt"
CAK = "countries/Cakhtlan.txt"
CAL = "countries/Caliban.txt"
CAR = "countries/Caranthea.txt"
CAS = "countries/Castanor.txt"
CAT = "countries/Castonia.txt"
CEL = "countries/Celras.txt"
CES = "countries/Cesa Rindaun.txt"
CHM = "countries/Chimeria.txt"
CIR = "countries/Cirion.txt"
COM = "countries/Comona.txt"
COR = "countries/Cordon.txt"
COT = "countries/Cortland.txt"
COV = "countries/Covania.txt"
COY = "countries/Corry.txt"
DAE = "countries/Daecon.txt"
DAD = "countries/Dande.txt"
DAN = "countries/Danmalis.txt"
DEF = "countries/Defiant.txt"
DON = "countries/Donfuer.txt"
DRA = "countries/Drak Yamar.txt"
DRE = "countries/Dreadvought.txt"
DYS = "countries/Dyshella.txt"
DZI = "countries/Dzitizan"
EIS = "countries/Eiszura.txt"
EJZ = "countries/Ejznrosa.txt"
ELD = "countries/Eldorath.txt"
END = "countries/Enderia.txt"
ENO = "countries/Enovatha.txt"
EPI = "countries/Epitchia.txt"
ERC = "countries/Ertcof.txt"
ERI = "countries/Eridonia.txt"
EXO = "countries/Exordium.txt"
FAV = "countries/Favei Clavaret.txt"
FLO = "countries/Floodhaven.txt"
GAL = "countries/Gallania.txt"
GAR = "countries/Gardenia.txt"
GEH = "countries/Gertek.txt"
GOL = "countries/Golden.txt"
GOR = "countries/Gorgossos.txt"
GRA = "countries/Gran Coran'i.txt"
GRC = "countries/Grand Castell.txt"
HAR = "countries/Harpia.txt"
HEL = "countries/Helsetia.txt"
HEM = "countries/Helmeria.txt"
HEZ = "countries/Hezion.txt"
HOD = "countries/Hodege.txt"
HYR = "countries/Hyria.txt"
IRI = "countries/Irithel.txt"
IRS = "countries/Irisnia.txt"
ISH = "countries/Ischanor.txt"
JAZ = "countries/Jarazeh.txt"
JOR = "countries/Jorthar.txt"
KAD = "countries/Kaddu.txt"
KAL = "countries/Kaltebaix.txt"
KAM = "countries/Kamtargaa.txt"
KAS = "countries/Kassylia.txt"
KEL = "countries/Kelpstine.txt"
KIC = "countries/Kiche.txt"
KHA = "countries/Khanen.txt"
KHR = "countries/Khrumaz.txt"
KUZ = "countries/Kuzina.txt"
KYR = "countries/Kyrin.txt"
LAT = "countries/Latria.txt"
LAV = "countries/Las Vidas.txt"
LEN = "countries/Lennox.txt"
LEV = "countries/Levan.txt"
LEY = "countries/Leyenbourg.txt"
LIR = "countries/Lir'ion.txt"
LIS = "countries/Lisvar.txt"
LIV = "countries/Livland.txt"
LOV = "countries/Lovvia.txt"
LPC = "countries/Lutian-Polonizian Commonwealth.txt"
LTO = "countries/Lutoge.txt"
LUT = "countries/Lutian.txt"
LYN = "countries/Lynarith.txt"
MAE = "countries/Maecenia.txt"
MAL = "countries/Malachite.txt"
MAR = "countries/Marisvalor.txt"
MIC = "countries/Michava.txt"
MID = "countries/Midjorv.txt"
MIZ = "countries/Mizlarai.txt"
MON = "countries/Monokleia.txt"
MYN = "countries/Myndelia.txt"
MYR = "countries/Myrtana.txt"
NAA = "countries/Naan.txt"
NUM = "countries/Numeos.txt"
OBL = "countries/Oblivion.txt"
OLD = "countries/Oldann.txt"
ORI = "countries/Orion.txt"
OSR = "countries/Osriguard.txt"
PAR = "countries/Paraiso.txt"
POL = "countries/Polonizia.txt"
QYN = "countries/Qynthos.txt"
RAM = "countries/Ramen.txt"
REG = "countries/Regnum.txt"
REN = "countries/Renesphey.txt"
RIT = "countries/Ritten an Tola.txt"
ROH = "countries/Rohldan.txt"
ROZ = "countries/Rozow.txt"
SAM = "countries/Samora.txt"
SAR = "countries/Sarinzerilin.txt"
SEA = "countries/Seawolves.txt"
SEL = "countries/Selidoar.txt"
SEN = "countries/Seneca.txt"
SET = "countries/Sentara.txt"
SHI = "countries/Shishuk.txt"
SKU = "countries/Skulfur.txt"
SON = "countries/Sonderia.txt"
STE = "countries/Steverovska.txt"
STR = "countries/Strategosia.txt"
SUN = "countries/Sundatano.txt"
SYL = "countries/Sylvas.txt"
SYR = "countries/Syren.txt"
TAN = "countries/Tandong.txt"
TAR = "countries/Taravor.txt"
TAU = "countries/Tauremar.txt"
TES = "countries/Testudo.txt"
TET = "countries/Testificas.txt"
THE = "countries/Thei√≥nikos.txt"
TIR = "countries/Tirgus.txt"
TRA = "countries/Trafalgar.txt"
TSI = "countries/Tsiladen.txt"
TSN = "countries/Tsunojiin.txt"
TSU = "countries/Tsuikinite.txt"
TYA = "countries/Tyahil.txt"
TZA = "countries/Tzainore.txt"
UET = "countries/Uetze.txt"
VAA = "countries/Valera.txt"
VAD = "countries/Valdic.txt"
VAL = "countries/Valora.txt"
VAR = "countries/Varaxis.txt"
VAS = "countries/Vastaros.txt"
VEA = "countries/Velarim.txt"
VEC = "countries/Vedanica.txt"
VED = "countries/Veldora.txt"
VEL = "countries/Veliskya.txt"
VER = "countries/Vermeria.txt"
VES = "countries/Vescognie.txt"
VET = "countries/Vertalios.txt"
VHA = "countries/Vhagaria.txt"
VID = "countries/Vidir-Arrak.txt"
VIN = "countries/Vinovia.txt"
VIR = "countries/Viratayn.txt"
VLA = "countries/Vladistan.txt"
YAR = "countries/Yarexoka.txt"
YIA = "countries/Yimmu Audal.txt"
YIM = "countries/Yimmuralia.txt"
YNQ = "countries/Ynqar.txt"
ZAI = "countries/Zaidan.txt"
ZAM = "countries/Zamotz.txt"
ZEH = "countries/Zehrniedrig.txt"
ZER = "countries/Zeril.txt"
ZIL = "countries/Zilatra.txt"
ZUR = "countries/Zuritan.txt"
